"filename", "language", "JavaScript", "JavaScript JSX", "comment", "blank", "total"
"/Users/elijahlawson/Desktop/Prime/divvy-tips/server/routes/bar.router.js", "JavaScript", 11, 0, 0, 1, 12
"/Users/elijahlawson/Desktop/Prime/divvy-tips/server/routes/drawers.router.js", "JavaScript", 1, 0, -1, 1, 1
"/Users/elijahlawson/Desktop/Prime/divvy-tips/server/routes/hours.router.js", "JavaScript", 23, 0, 0, 5, 28
"/Users/elijahlawson/Desktop/Prime/divvy-tips/server/routes/shift.router.js", "JavaScript", 14, 0, 0, 4, 18
"/Users/elijahlawson/Desktop/Prime/divvy-tips/server/routes/shiftTips.router.js", "JavaScript", -38, 0, -3, -10, -51
"/Users/elijahlawson/Desktop/Prime/divvy-tips/server/routes/tips.router.js", "JavaScript", 54, 0, 0, 13, 67
"/Users/elijahlawson/Desktop/Prime/divvy-tips/server/server.js", "JavaScript", 2, 0, 0, 0, 2
"/Users/elijahlawson/Desktop/Prime/divvy-tips/src/components/AddTips/AddTips.jsx", "JavaScript JSX", 0, 22, 0, 4, 26
"/Users/elijahlawson/Desktop/Prime/divvy-tips/src/components/App/App.jsx", "JavaScript JSX", 0, 9, 0, 2, 11
"/Users/elijahlawson/Desktop/Prime/divvy-tips/src/components/HoursConfirmation/HoursConfirmation.jsx", "JavaScript JSX", 0, 57, 0, 14, 71
"/Users/elijahlawson/Desktop/Prime/divvy-tips/src/components/ShiftSetup/ShiftSetup.jsx", "JavaScript JSX", 0, 12, 0, 2, 14
"/Users/elijahlawson/Desktop/Prime/divvy-tips/src/components/TipsConfirmation/TipsConfirmation.jsx", "JavaScript JSX", 0, 11, 0, 3, 14
"/Users/elijahlawson/Desktop/Prime/divvy-tips/src/components/UserPage/UserPage.jsx", "JavaScript JSX", 0, 7, 0, 1, 8
"/Users/elijahlawson/Desktop/Prime/divvy-tips/src/components/UserRegister/UserRegister.jsx", "JavaScript JSX", 0, -4, 0, 0, -4
"/Users/elijahlawson/Desktop/Prime/divvy-tips/src/redux/reducers/_root.reducer.js", "JavaScript", 6, 0, 0, 0, 6
"/Users/elijahlawson/Desktop/Prime/divvy-tips/src/redux/reducers/currentShift.reducer.js", "JavaScript", 9, 0, 0, 1, 10
"/Users/elijahlawson/Desktop/Prime/divvy-tips/src/redux/reducers/hours.reducer.js", "JavaScript", 9, 0, 0, 1, 10
"/Users/elijahlawson/Desktop/Prime/divvy-tips/src/redux/reducers/userTips.reducer.js", "JavaScript", 9, 0, 0, 1, 10
"/Users/elijahlawson/Desktop/Prime/divvy-tips/src/redux/sagas/_root.saga.js", "JavaScript", 2, 0, 0, 0, 2
"/Users/elijahlawson/Desktop/Prime/divvy-tips/src/redux/sagas/bars.saga.js", "JavaScript", 9, 0, 0, 1, 10
"/Users/elijahlawson/Desktop/Prime/divvy-tips/src/redux/sagas/hours.saga.js", "JavaScript", 14, 0, 0, 3, 17
"/Users/elijahlawson/Desktop/Prime/divvy-tips/src/redux/sagas/registration.saga.js", "JavaScript", 1, 0, 0, 0, 1
"/Users/elijahlawson/Desktop/Prime/divvy-tips/src/redux/sagas/shiftTips.saga.js", "JavaScript", -23, 0, 0, -5, -28
"/Users/elijahlawson/Desktop/Prime/divvy-tips/src/redux/sagas/shifts.saga.js", "JavaScript", 9, 0, 0, 1, 10
"/Users/elijahlawson/Desktop/Prime/divvy-tips/src/redux/sagas/tips.saga.js", "JavaScript", 32, 0, 0, 7, 39
"Total", "-", 144, 114, -4, 50, 304